{
  "width": 10,
  "height": 8,
  "tiles": [
    [0, 0, 0, 0, 0, 0, 0, 0, 0, 0],
    [0, 0, 0, 0, 0, 0, 0, 0, 0, 0],
    [0, 1, 0, 0, 1, 0, 0, 1, 0, 0],
    [0, 1, 0, 0, 1, 0, 0, 0, 1, 0],
    [0, 0, 1, 1, 0, 0, 0, 0, 0, 1],
    [0, 0, 0, 0, 0, 0, 0, 0, 0, 0],
    [0, 0, 0, 0, 1, 1, 0, 0, 0, 1],
    [0, 0, 0, 0, 1, 1, 0, 0, 1, 1]
  ]
}
